59 55 55 55 55 55 55 55 55 55 55 55 55 55 55 55 55 55 59
58 10 10 10 10 10 10 10 10 10 10 10 10 10 10 10 10 10 56
58 10 10 10 10 10 10 10 10 10 10 10 10 10 10 10 22 21 56
58 10 10 10 10 10 10 10 10 10 10 10 10 10 28 24 20 19 56
58 10 10 10 10 10 10 10 10 10 10 10 10 10 23 10 10 10 56
58 10 24 24 24 25 10 10 10 10 10 10 10 10 23 10 10 10 56
58 10 10 10 10 26 24 24 24 24 24 24 24 24 27 10 10 10 56
58 10 10 10 10 10 10 10 10 10 10 10 10 10 10 10 10 10 56
58 10 10 10 10 10 10 10 10 10 10 10 10 10 10 10 10 10 56
58 10 10 10 10 10 10 10 10 10 10 10 10 10 10 10 10 10 56
58 10 10 10 10 10 10 10 10 10 10 10 10 10 10 10 10 10 56
58 10 10 10 10 10 10 10 10 10 10 10 10 10 10 10 10 10 56
59 57 57 57 57 57 57 57 57 57 57 57 57 57 57 57 57 57 59


// 0-grass 1-stone 2-wood

