59 60 60 60 60 60 60 60 60 60 60 60 60 60 60 60 60 60 69
63 30 30 30 30 30 30 30 30 30 30 30 30 30 30 30 30 30 61
63 32 32 32 33 30 30 30 30 30 30 30 30 30 30 30 30 30 61
63 30 30 30 31 30 30 30 30 30 30 30 30 30 30 30 30 30 61
63 30 30 30 31 30 30 30 30 30 30 30 30 30 30 30 30 30 61
63 30 30 30 31 30 30 30 30 30 30 30 30 30 30 30 30 30 61
63 30 30 30 31 30 30 30 30 30 30 30 30 30 30 30 30 30 61
63 30 30 30 31 30 30 30 30 30 30 30 30 30 30 30 30 30 61
63 30 30 30 34 32 32 32 32 33 30 30 30 30 30 30 30 30 61
63 30 30 30 30 30 30 30 30 31 30 30 30 30 30 30 47 48 61
63 30 30 30 30 30 30 30 30 34 32 32 32 32 32 32 49 50 61
63 30 30 30 30 30 30 30 30 30 30 30 30 30 30 30 30 30 61
59 62 62 62 62 62 62 62 62 62 62 62 62 62 62 62 62 62 59
