59 64 64 64 64 64 64 64 64 64 64 64 64 64 64 64 64 64 59
67 40 40 40 40 40 40 40 40 40 40 40 40 40 40 40 40 40 65
67 42 42 42 42 42 42 42 42 42 42 42 42 42 42 42 43 40 65
67 40 40 40 40 40 40 40 40 40 40 40 40 40 40 40 41 40 65
67 40 40 40 40 40 40 40 40 40 40 40 40 40 40 40 41 40 65
67 40 40 40 40 40 40 40 40 40 40 40 40 40 40 40 41 40 65
67 40 40 40 40 40 40 40 40 40 40 40 40 40 40 40 41 40 65
67 40 40 40 40 40 40 40 40 40 40 40 40 40 40 40 41 40 65
67 51 52 40 40 40 40 40 40 40 40 40 40 40 40 40 41 40 65
67 53 54 40 40 40 40 40 40 40 40 40 40 40 40 40 41 40 65
67 42 42 42 42 42 42 42 42 42 42 42 42 42 42 42 45 40 65
67 40 40 40 40 40 40 40 40 40 40 40 40 40 40 40 40 40 65
59 66 66 66 66 66 66 66 66 66 66 66 66 66 66 66 66 66 59

